1111111111111
1P01111111001
1000011111001
1011111E00C01
1111111111111
