11111111111111
1P01000C000001
11010000001001
100E00000E1001
11111111111111
11111111111111
