11111111111111
1P0C0000000001
11000000001001
1C0E0000001001
11111111111111