111111111111111
1P0000100000C01
101110111011101
1C0001000000001
111101011101101
1C00C0000E00001
111111111111111
