11111
1P0C1
10101
1C0E1
10001
11111
