11111111111111111111
1P00001000000C0000E1
10111101111111011111
10000000000000000001
1C001001100010000001
11111111111111111111
